[[9,1,1,9,9,9,3,3,3,3,1,1,1,9,9,9,1,1,9,9]
 [1,1,1,1,1,3,1,2,1,1,1,1,9,1,1,9,1,1,1,1]
 [1,1,1,1,1,3,2,2,2,2,1,1,9,1,1,9,1,1,1,1]
 [2,1,1,1,1,3,1,1,2,2,9,9,1,1,1,9,1,1,1,1]
 [1,1,1,1,1,3,1,9,9,9,1,1,1,1,1,9,1,1,1,1]
 [1,1,1,1,1,3,3,1,1,1,1,2,1,1,1,9,1,1,1,1]
 [1,1,1,1,1,1,3,1,1,1,2,1,1,1,1,9,1,1,1,2]
 [1,1,1,1,1,1,3,1,1,1,1,2,1,1,1,9,9,9,1,2]
 [1,1,9,9,1,3,3,1,1,9,9,1,1,1,9,1,1,9,1,1]
 [9,9,1,1,1,3,1,1,1,1,9,9,9,9,1,1,1,9,1,1]
 [5,2,2,1,1,3,1,1,1,1,1,2,2,2,1,1,1,9,1,1]
 [5,2,2,9,1,3,3,3,3,1,2,2,2,2,1,1,1,9,1,1]
 [5,2,2,9,1,1,1,1,3,1,1,1,2,2,1,1,1,1,9,1]
 [5,5,9,1,1,1,1,1,3,1,1,1,2,2,1,2,1,1,9,1]
 [5,5,5,9,9,9,1,1,3,1,1,1,2,1,2,1,1,9,1,2]
 [5,5,5,5,5,9,1,1,3,1,1,1,1,1,1,1,1,1,1,2]
 [5,5,5,5,5,9,1,1,3,1,1,1,1,1,1,1,1,1,1,1]
 [5,5,5,5,5,9,1,1,3,3,3,3,1,1,1,3,3,3,1,1]
 [5,5,5,5,5,9,1,1,1,3,1,3,3,3,3,3,1,1,1,2]
 [5,5,5,5,5,5,9,1,1,3,1,1,1,1,1,1,1,2,2,2]]